0 0 1 9 1 2 1 1 0 0 0 0
 0 0 9 9 1 2 1 1 0 0 0 0
0 0 1 1 9 1 1 3 3 0 0 0
 0 0 8 1 1 4 1 1 0 0 0
0 0 8 8 1 4 1 5 5 0 0 0
 0 0 1 1 1 1 1 5 0 0 0
0 0 1 1 7 1 6 1 0 0 0 0
 0 0 1 1 1 1 1 0 0 0 0
