1 2 1 1 0 0 0 0
 1 2 1 1 0 0 0 0
1 1 1 3 3 0 0 0
 1 4 1 1 0 0 0
1 4 1 5 1 0 0 0
 1 1 1 1 0 0 0
0 1 6 1 0 0 0 0
 0 1 1 0 0 0 0
